G 0 0 W 0
T 1 0 B 0
X 2 0 B 0
B 3 0 B 0
P 0 1 B 0
D 1 1 B 0
F 2 1 W 0
W 3 1 B 0
P 0 0 W C
S 0 0 W S
E 0 0 W E
C 0 2 0 0
!
20 20
WWWBBBBWWWWWWWWWWWWW
WGGBDBBGPWWGPGWWWWWW
WGEGGGGGGWWWGGWWWWPT
WGGGGGGGGWWWWGWTTGGT
TGGTTTTTTTTTTGTTTGET
TGGGGXGGGTTTGETTTGGT
TGGEGGGGGTTTGGTTTETT
TGGGGXGGGGGGGGGGGGGT
TGGGGXGSGTTTGTTTTTGT
TTTTTTTTTTTTGTTTTEGT
TGGGGGTTTGGGGGXTGGGT
TGGGGEGGGGXXGGXXEGTT
TGPGGGGXXXXXXGGGXGPT
TGGGGXXXXXXXXXTGTXTT
XXXXXXXXXXXXXGGGXXXX
XXXXXXXXXXXXGGXXXXXX
XPXXXXXXXXXXGEXXXXXX
XGGGGXXXXXXXGXXXXXXX
XXXXGGGGGGGGGGXXXXXX
XXXXXXXXXXXXXXXXXXXX